Team,Matches,Won,Drawn,Lost,GF,GA,GD,Points,Rank
Philadelphia Union,1,1,0,0,3,1,2,3,1
Houston Dynamo,1,0,0,1,2,0,2,0,2
FC Dallas,1,0,0,1,3,2,1,0,3
Nashville SC,1,0,0,1,2,1,1,0,4
Los Angeles FC,1,0,0,1,1,0,1,0,5
Los Angeles Galaxy,1,0,0,1,2,2,0,0,6
San Jose Earthquakes,1,0,0,1,1,1,0,0,7
CF Montreal,1,0,0,1,1,1,0,0,8
Charlotte FC,1,0,0,1,1,1,0,0,9
New York City FC,1,0,0,1,1,1,0,0,10
New York Red Bulls,1,0,0,1,1,1,0,0,11
Orlando City,1,0,0,1,0,0,0,0,12
New England Revolution,1,0,0,1,0,0,0,0,13
Minnesota,1,0,0,1,0,0,0,0,14
Portland Timbers,1,0,0,1,2,3,-1,0,15
Austin FC,1,0,0,1,1,2,-1,0,16
Real Salt Lake,1,0,0,1,1,2,-1,0,17
Atlanta United FC,1,0,0,1,0,1,-1,0,18
Vancouver Whitecaps,1,0,0,1,0,1,-1,0,19
Columbus Crew,1,0,0,1,1,3,-2,0,20
Sporting Kansas City,1,0,0,1,1,3,-2,0,21
Inter Miami,1,0,0,1,0,2,-2,0,22
Seattle Sounders,1,0,0,1,0,3,-3,0,23
Chicago Fire,1,0,0,1,0,3,-3,0,24
FC Cincinnati,1,0,0,1,1,5,-4,0,25
Colorado Rapids,1,0,0,1,0,4,-4,0,26
Toronto FC,1,0,0,1,1,6,-5,0,27
D.C. United,1,0,0,1,0,5,-5,0,28
Philadelphia Union,2,2,0,0,3,2,1,6,1
FC Dallas,2,0,1,1,6,3,3,1,2
Los Angeles FC,2,0,1,1,4,3,1,1,3
Austin FC,2,0,1,1,3,2,1,1,4
New York City FC,2,0,1,1,3,2,1,1,5
Los Angeles Galaxy,2,0,1,1,3,3,0,1,6
CF Montreal,2,0,1,1,2,2,0,1,7
Nashville SC,2,0,1,1,2,2,0,1,8
New York Red Bulls,2,0,1,1,1,3,-2,1,9
Columbus Crew,2,0,1,1,3,7,-4,1,10
FC Cincinnati,2,0,1,1,1,8,-7,1,11
Houston Dynamo,2,0,0,2,3,1,2,0,12
San Jose Earthquakes,2,0,0,2,2,2,0,0,13
Charlotte FC,2,0,0,2,2,2,0,0,14
Orlando City,2,0,0,2,1,1,0,0,15
Vancouver Whitecaps,2,0,0,2,1,2,-1,0,16
New England Revolution,2,0,0,2,0,1,-1,0,17
Minnesota,2,0,0,2,0,1,-1,0,18
Sporting Kansas City,2,0,0,2,2,4,-2,0,19
Atlanta United FC,2,0,0,2,0,2,-2,0,20
Portland Timbers,2,0,0,2,3,6,-3,0,21
Colorado Rapids,2,0,0,2,2,5,-3,0,22
Real Salt Lake,2,0,0,2,2,5,-3,0,23
Inter Miami,2,0,0,2,1,5,-4,0,24
Seattle Sounders,2,0,0,2,1,5,-4,0,25
Chicago Fire,2,0,0,2,1,6,-5,0,26
D.C. United,2,0,0,2,1,8,-7,0,27
Toronto FC,2,0,0,2,1,9,-8,0,28
Philadelphia Union,3,3,0,0,5,5,0,9,1
Los Angeles FC,3,0,2,1,4,5,-1,2,2
Columbus Crew,3,0,2,1,6,10,-4,2,3
FC Dallas,3,0,1,2,6,3,3,1,4
Austin FC,3,0,1,2,4,6,-2,1,5
CF Montreal,3,0,1,2,2,4,-2,1,6
Los Angeles Galaxy,3,0,1,2,3,6,-3,1,7
New York City FC,3,0,1,2,3,7,-4,1,8
New York Red Bulls,3,0,1,2,1,6,-5,1,9
Nashville SC,3,0,1,2,2,8,-6,1,10
FC Cincinnati,3,0,1,2,1,15,-14,1,11
San Jose Earthquakes,3,0,0,3,6,4,2,0,12
Houston Dynamo,3,0,0,3,3,2,1,0,13
Orlando City,3,0,0,3,2,4,-2,0,14
Charlotte FC,3,0,0,3,2,4,-2,0,15
Seattle Sounders,3,0,0,3,2,5,-3,0,16
Vancouver Whitecaps,3,0,0,3,1,4,-3,0,17
Sporting Kansas City,3,0,0,3,2,6,-4,0,18
New England Revolution,3,0,0,3,0,4,-4,0,19
Minnesota,3,0,0,3,0,4,-4,0,20
Atlanta United FC,3,0,0,3,1,6,-5,0,21
Inter Miami,3,0,0,3,3,9,-6,0,22
Colorado Rapids,3,0,0,3,3,9,-6,0,23
Real Salt Lake,3,0,0,3,3,9,-6,0,24
Portland Timbers,3,0,0,3,4,11,-7,0,25
Chicago Fire,3,0,0,3,2,9,-7,0,26
Toronto FC,3,0,0,3,2,11,-9,0,27
D.C. United,3,0,0,3,1,11,-10,0,28
Philadelphia Union,4,4,0,0,7,6,1,12,1
Los Angeles FC,4,1,2,1,8,6,2,5,2
Columbus Crew,4,0,3,1,7,13,-6,3,3
FC Dallas,4,0,2,2,7,7,0,2,4
New York City FC,4,0,2,2,4,7,-3,2,5
Nashville SC,4,0,2,2,4,9,-5,2,6
CF Montreal,4,0,1,3,5,5,0,1,7
Austin FC,4,0,1,3,5,6,-1,1,8
Los Angeles Galaxy,4,0,1,3,3,6,-3,1,9
New York Red Bulls,4,0,1,3,1,7,-6,1,10
FC Cincinnati,4,0,1,3,1,15,-14,1,11
San Jose Earthquakes,4,0,0,4,8,4,4,0,12
Charlotte FC,4,0,0,4,5,5,0,0,13
Houston Dynamo,4,0,0,4,3,3,0,0,14
Orlando City,4,0,0,4,4,6,-2,0,15
Minnesota,4,0,0,4,2,4,-2,0,16
Seattle Sounders,4,0,0,4,4,7,-3,0,17
Vancouver Whitecaps,4,0,0,4,2,6,-4,0,18
Atlanta United FC,4,0,0,4,2,7,-5,0,19
New England Revolution,4,0,0,4,2,7,-5,0,20
Colorado Rapids,4,0,0,4,4,10,-6,0,21
Sporting Kansas City,4,0,0,4,3,9,-6,0,22
Real Salt Lake,4,0,0,4,3,9,-6,0,23
Portland Timbers,4,0,0,4,6,13,-7,0,24
Inter Miami,4,0,0,4,4,11,-7,0,25
Chicago Fire,4,0,0,4,4,12,-8,0,26
Toronto FC,4,0,0,4,4,13,-9,0,27
D.C. United,4,0,0,4,2,15,-13,0,28
Philadelphia Union,5,5,0,0,12,6,6,15,1
Los Angeles FC,5,2,2,1,8,6,2,8,2
FC Dallas,5,1,2,2,7,8,-1,5,3
Columbus Crew,5,0,4,1,7,15,-8,4,4
New York City FC,5,0,3,2,5,8,-3,3,5
Austin FC,5,0,2,3,6,8,-2,2,6
Nashville SC,5,0,2,3,4,9,-5,2,7
CF Montreal,5,0,1,4,6,6,0,1,8
Los Angeles Galaxy,5,0,1,4,3,8,-5,1,9
New York Red Bulls,5,0,1,4,3,10,-7,1,10
FC Cincinnati,5,0,1,4,4,18,-14,1,11
San Jose Earthquakes,5,0,0,5,9,6,3,0,12
Orlando City,5,0,0,5,7,7,0,0,13
Houston Dynamo,5,0,0,5,4,4,0,0,14
Vancouver Whitecaps,5,0,0,5,5,6,-1,0,15
Charlotte FC,5,0,0,5,5,8,-3,0,16
Minnesota,5,0,0,5,2,6,-4,0,17
New England Revolution,5,0,0,5,4,9,-5,0,18
Portland Timbers,5,0,0,5,7,14,-7,0,19
Seattle Sounders,5,0,0,5,5,12,-7,0,20
Sporting Kansas City,5,0,0,5,5,12,-7,0,21
Colorado Rapids,5,0,0,5,5,12,-7,0,22
Inter Miami,5,0,0,5,5,13,-8,0,23
Real Salt Lake,5,0,0,5,4,12,-8,0,24
Toronto FC,5,0,0,5,6,15,-9,0,25
Chicago Fire,5,0,0,5,4,13,-9,0,26
Atlanta United FC,5,0,0,5,2,11,-9,0,27
D.C. United,5,0,0,5,3,20,-17,0,28
Philadelphia Union,6,6,0,0,14,6,8,18,1
Los Angeles FC,6,3,2,1,12,7,5,11,2
Columbus Crew,6,1,4,1,10,16,-6,7,3
FC Dallas,6,1,3,2,7,10,-3,6,4
New York City FC,6,1,3,2,7,10,-3,6,5
Austin FC,6,1,2,3,8,11,-3,5,6
Nashville SC,6,1,2,3,6,11,-5,5,7
CF Montreal,6,1,1,4,11,7,4,4,8
Los Angeles Galaxy,6,1,1,4,6,8,-2,4,9
New York Red Bulls,6,1,1,4,6,10,-4,4,10
FC Cincinnati,6,1,1,4,8,19,-11,4,11
San Jose Earthquakes,6,0,1,5,11,9,2,1,12
Vancouver Whitecaps,6,0,1,5,7,6,1,1,13
Houston Dynamo,6,0,1,5,5,6,-1,1,14
Charlotte FC,6,0,1,5,8,10,-2,1,15
Orlando City,6,0,1,5,8,12,-4,1,16
New England Revolution,6,0,1,5,4,9,-5,1,17
Minnesota,6,0,1,5,4,9,-5,1,18
Portland Timbers,6,0,1,5,8,15,-7,1,19
Seattle Sounders,6,0,1,5,7,14,-7,1,20
Sporting Kansas City,6,0,1,5,6,13,-7,1,21
Chicago Fire,6,0,1,5,7,15,-8,1,22
Atlanta United FC,6,0,1,5,6,14,-8,1,23
Colorado Rapids,6,0,1,5,6,14,-8,1,24
Inter Miami,6,0,1,5,6,15,-9,1,25
Toronto FC,6,0,1,5,6,15,-9,1,26
Real Salt Lake,6,0,1,5,4,13,-9,1,27
D.C. United,6,0,0,6,4,22,-18,0,28
Philadelphia Union,7,7,0,0,15,7,8,21,1
Los Angeles FC,7,4,2,1,15,7,8,14,2
Columbus Crew,7,2,4,1,13,17,-4,10,3
FC Dallas,7,2,3,2,7,11,-4,9,4
New York City FC,7,1,4,2,9,11,-2,7,5
Austin FC,7,1,3,3,11,14,-3,6,6
Nashville SC,7,1,3,3,6,12,-6,6,7
CF Montreal,7,1,2,4,12,9,3,5,8
New York Red Bulls,7,1,2,4,8,10,-2,5,9
Los Angeles Galaxy,7,1,2,4,7,11,-4,5,10
FC Cincinnati,7,1,2,4,10,20,-10,5,11
Charlotte FC,7,0,2,5,10,12,-2,2,12
Orlando City,7,0,2,5,9,14,-5,2,13
New England Revolution,7,0,2,5,5,10,-5,2,14
Minnesota,7,0,2,5,5,11,-6,2,15
Portland Timbers,7,0,2,5,9,16,-7,2,16
Seattle Sounders,7,0,2,5,8,15,-7,2,17
Atlanta United FC,7,0,2,5,7,16,-9,2,18
Real Salt Lake,7,0,2,5,4,13,-9,2,19
San Jose Earthquakes,7,0,1,6,12,12,0,1,20
Vancouver Whitecaps,7,0,1,6,9,9,0,1,21
Houston Dynamo,7,0,1,6,7,9,-2,1,22
Sporting Kansas City,7,0,1,6,9,14,-5,1,23
Chicago Fire,7,0,1,6,7,17,-10,1,24
Inter Miami,7,0,1,6,6,16,-10,1,25
Toronto FC,7,0,1,6,6,16,-10,1,26
Colorado Rapids,7,0,1,6,6,18,-12,1,27
D.C. United,7,0,1,6,6,22,-16,1,28
Philadelphia Union,8,8,0,0,18,9,9,24,1
Los Angeles FC,8,5,2,1,19,9,10,17,2
Columbus Crew,8,3,4,1,14,18,-4,13,3
FC Dallas,8,3,3,2,11,12,-1,12,4
Austin FC,8,2,3,3,13,14,-1,9,5
New York City FC,8,1,5,2,12,14,-2,8,6
Nashville SC,8,1,4,3,6,14,-8,7,7
New York Red Bulls,8,1,3,4,11,11,0,6,8
CF Montreal,8,1,3,4,12,13,-1,6,9
Los Angeles Galaxy,8,1,3,4,7,12,-5,6,10
FC Cincinnati,8,1,3,4,10,24,-14,6,11
Charlotte FC,8,0,3,5,13,15,-2,3,12
New England Revolution,8,0,3,5,6,11,-5,3,13
Minnesota,8,0,3,5,5,12,-7,3,14
Portland Timbers,8,0,3,5,10,18,-8,3,15
Seattle Sounders,8,0,3,5,9,17,-8,3,16
Atlanta United FC,8,0,3,5,7,16,-9,3,17
Real Salt Lake,8,0,3,5,4,14,-10,3,18
Orlando City,8,0,2,6,9,16,-7,2,19
Inter Miami,8,0,2,6,7,19,-12,2,20
San Jose Earthquakes,8,0,1,7,14,13,1,1,21
Vancouver Whitecaps,8,0,1,7,9,11,-2,1,22
Houston Dynamo,8,0,1,7,8,10,-2,1,23
Sporting Kansas City,8,0,1,7,10,14,-4,1,24
Toronto FC,8,0,1,7,10,18,-8,1,25
Colorado Rapids,8,0,1,7,7,20,-13,1,26
Chicago Fire,8,0,1,7,7,21,-14,1,27
D.C. United,8,0,1,7,8,23,-15,1,28
Philadelphia Union,9,9,0,0,18,9,9,27,1
Los Angeles FC,9,6,2,1,21,13,8,20,2
Columbus Crew,9,4,4,1,17,19,-2,16,3
FC Dallas,9,4,3,2,13,13,0,15,4
Austin FC,9,3,3,3,18,15,3,12,5
New York City FC,9,1,6,2,13,15,-2,9,6
Nashville SC,9,1,5,3,7,17,-10,8,7
CF Montreal,9,1,4,4,15,14,1,7,8
New York Red Bulls,9,1,4,4,13,12,1,7,9
Los Angeles Galaxy,9,1,4,4,11,13,-2,7,10
FC Cincinnati,9,1,4,4,11,26,-15,7,11
Charlotte FC,9,0,3,6,14,18,-4,3,12
New England Revolution,9,0,3,6,7,12,-5,3,13
Portland Timbers,9,0,3,6,12,20,-8,3,14
Minnesota,9,0,3,6,5,13,-8,3,15
Seattle Sounders,9,0,3,6,10,19,-9,3,16
Atlanta United FC,9,0,3,6,9,20,-11,3,17
Real Salt Lake,9,0,3,6,4,16,-12,3,18
San Jose Earthquakes,9,0,2,7,15,16,-1,2,19
Orlando City,9,0,2,7,12,17,-5,2,20
Inter Miami,9,0,2,7,9,23,-14,2,21
Houston Dynamo,9,0,1,8,11,10,1,1,22
Vancouver Whitecaps,9,0,1,8,11,13,-2,1,23
Sporting Kansas City,9,0,1,8,10,18,-8,1,24
Toronto FC,9,0,1,8,10,21,-11,1,25
D.C. United,9,0,1,8,11,23,-12,1,26
Chicago Fire,9,0,1,8,8,23,-15,1,27
Colorado Rapids,9,0,1,8,8,23,-15,1,28
Philadelphia Union,10,10,0,0,19,9,10,30,1
Los Angeles FC,10,7,2,1,26,14,12,23,2
Columbus Crew,10,5,4,1,18,20,-2,19,3
FC Dallas,10,5,3,2,13,15,-2,18,4
Austin FC,10,4,3,3,20,16,4,15,5
New York City FC,10,1,7,2,15,16,-1,10,6
Nashville SC,10,1,6,3,8,20,-12,9,7
CF Montreal,10,1,5,4,19,15,4,8,8
New York Red Bulls,10,1,5,4,14,14,0,8,9
Los Angeles Galaxy,10,1,5,4,13,14,-1,8,10
FC Cincinnati,10,1,5,4,12,27,-15,8,11
Charlotte FC,10,0,4,6,15,18,-3,4,12
Portland Timbers,10,0,4,6,16,20,-4,4,13
Minnesota,10,0,4,6,7,13,-6,4,14
New England Revolution,10,0,4,6,7,15,-8,4,15
Seattle Sounders,10,0,4,6,11,20,-9,4,16
Atlanta United FC,10,0,4,6,10,20,-10,4,17
Real Salt Lake,10,0,4,6,5,17,-12,4,18
Inter Miami,10,0,3,7,9,24,-15,3,19
San Jose Earthquakes,10,0,2,8,18,17,1,2,20
Orlando City,10,0,2,8,12,17,-5,2,21
Chicago Fire,10,0,2,8,9,23,-14,2,22
Houston Dynamo,10,0,1,9,11,11,0,1,23
Vancouver Whitecaps,10,0,1,9,11,15,-4,1,24
Sporting Kansas City,10,0,1,9,11,18,-7,1,25
Toronto FC,10,0,1,9,11,23,-12,1,26
D.C. United,10,0,1,9,11,24,-13,1,27
Colorado Rapids,10,0,1,9,11,24,-13,1,28
Philadelphia Union,11,11,0,0,21,11,10,33,1
Los Angeles FC,11,8,2,1,29,15,14,26,2
Columbus Crew,11,6,4,1,19,20,-1,22,3
FC Dallas,11,6,3,2,15,17,-2,21,4
Austin FC,11,5,3,3,22,17,5,18,5
New York City FC,11,1,8,2,16,18,-2,11,6
Nashville SC,11,1,7,3,9,21,-12,10,7
CF Montreal,11,1,6,4,22,17,5,9,8
Los Angeles Galaxy,11,1,6,4,16,16,0,9,9
New York Red Bulls,11,1,6,4,16,17,-1,9,10
FC Cincinnati,11,1,6,4,14,28,-14,9,11
Portland Timbers,11,0,5,6,16,22,-6,5,12
Minnesota,11,0,5,6,7,13,-6,5,13
Real Salt Lake,11,0,5,6,8,18,-10,5,14
New England Revolution,11,0,5,6,7,17,-10,5,15
Seattle Sounders,11,0,5,6,11,22,-11,5,16
Charlotte FC,11,0,4,7,15,20,-5,4,17
Atlanta United FC,11,0,4,7,10,21,-11,4,18
Inter Miami,11,0,4,7,9,25,-16,4,19
San Jose Earthquakes,11,0,3,8,24,19,5,3,20
Orlando City,11,0,3,8,13,19,-6,3,21
D.C. United,11,0,2,9,13,25,-12,2,22
Chicago Fire,11,0,2,9,10,25,-15,2,23
Houston Dynamo,11,0,1,10,12,13,-1,1,24
Vancouver Whitecaps,11,0,1,10,14,16,-2,1,25
Sporting Kansas City,11,0,1,10,13,20,-7,1,26
Toronto FC,11,0,1,10,12,23,-11,1,27
Colorado Rapids,11,0,1,10,12,24,-12,1,28
Philadelphia Union,12,12,0,0,21,13,8,36,1
Los Angeles FC,12,9,2,1,33,16,17,29,2
FC Dallas,12,7,3,2,17,19,-2,24,3
Columbus Crew,12,6,5,1,20,21,-1,23,4
Austin FC,12,6,3,3,23,18,5,21,5
New York City FC,12,1,9,2,18,19,-1,12,6
Nashville SC,12,1,8,3,9,24,-15,11,7
New York Red Bulls,12,1,7,4,16,21,-5,10,8
CF Montreal,12,1,6,5,22,19,3,9,9
Los Angeles Galaxy,12,1,6,5,16,18,-2,9,10
FC Cincinnati,12,1,6,5,14,29,-15,9,11
Inter Miami,12,1,4,7,10,25,-15,7,12
Portland Timbers,12,0,6,6,17,25,-8,6,13
Atlanta United FC,12,0,5,7,15,21,-6,5,14
Minnesota,12,0,5,7,8,14,-6,5,15
Seattle Sounders,12,0,5,7,13,25,-12,5,16
Real Salt Lake,12,0,5,7,8,20,-12,5,17
New England Revolution,12,0,5,7,7,19,-12,5,18
San Jose Earthquakes,12,0,4,8,27,21,6,4,19
Charlotte FC,12,0,4,8,16,24,-8,4,20
Orlando City,12,0,3,9,13,22,-9,3,21
D.C. United,12,0,3,9,16,27,-11,3,22
Chicago Fire,12,0,2,10,12,28,-16,2,23
Houston Dynamo,12,0,1,11,17,13,4,1,24
Vancouver Whitecaps,12,0,1,11,14,16,-2,1,25
Sporting Kansas City,12,0,1,11,14,22,-8,1,26
Colorado Rapids,12,0,1,11,13,25,-12,1,27
Toronto FC,12,0,1,11,15,28,-13,1,28
Philadelphia Union,13,13,0,0,24,13,11,39,1
Los Angeles FC,13,10,2,1,36,16,20,32,2
FC Dallas,13,8,3,2,18,20,-2,27,3
Columbus Crew,13,7,5,1,21,22,-1,26,4
Austin FC,13,7,3,3,24,21,3,24,5
New York City FC,13,1,10,2,20,21,-1,13,6
Los Angeles Galaxy,13,2,6,5,17,18,-1,12,7
Nashville SC,13,1,9,3,13,24,-11,12,8
New York Red Bulls,13,1,8,4,17,23,-6,11,9
Inter Miami,13,2,4,7,13,26,-13,10,10
CF Montreal,13,1,7,5,24,24,0,10,11
FC Cincinnati,13,1,7,5,16,30,-14,10,12
San Jose Earthquakes,13,1,4,8,28,23,5,7,13
Portland Timbers,13,0,7,6,17,28,-11,7,14
Minnesota,13,0,6,7,9,16,-7,6,15
Seattle Sounders,13,0,6,7,15,25,-10,6,16
Real Salt Lake,13,0,6,7,10,21,-11,6,17
New England Revolution,13,0,6,7,8,19,-11,6,18
Atlanta United FC,13,0,5,8,17,24,-7,5,19
Charlotte FC,13,0,5,8,17,29,-12,5,20
Orlando City,13,0,4,9,16,23,-7,4,21
D.C. United,13,0,4,9,17,28,-11,4,22
Chicago Fire,13,0,3,10,13,30,-17,3,23
Sporting Kansas City,13,0,2,11,15,24,-9,2,24
Colorado Rapids,13,0,2,11,13,27,-14,2,25
Houston Dynamo,13,0,1,12,18,15,3,1,26
Vancouver Whitecaps,13,0,1,12,15,17,-2,1,27
Toronto FC,13,0,1,12,18,29,-11,1,28
Philadelphia Union,14,14,0,0,24,13,11,42,1
Los Angeles FC,14,11,2,1,37,16,21,35,2
FC Dallas,14,9,3,2,18,20,-2,30,3
Columbus Crew,14,8,5,1,23,23,0,29,4
Austin FC,14,8,3,3,28,21,7,27,5
New York City FC,14,1,11,2,23,22,1,14,6
Los Angeles Galaxy,14,2,7,5,18,22,-4,13,7
Nashville SC,14,1,10,3,13,26,-13,13,8
New York Red Bulls,14,1,9,4,18,24,-6,12,9
Inter Miami,14,2,5,7,14,27,-13,11,10
CF Montreal,14,1,8,5,27,25,2,11,11
FC Cincinnati,14,1,8,5,16,30,-14,11,12
San Jose Earthquakes,14,2,4,8,30,24,6,10,13
Portland Timbers,14,1,7,6,19,29,-10,10,14
Atlanta United FC,14,0,6,8,19,25,-6,6,15
Minnesota,14,0,6,8,10,17,-7,6,16
Seattle Sounders,14,0,6,8,17,25,-8,6,17
Real Salt Lake,14,0,6,8,12,22,-10,6,18
New England Revolution,14,0,6,8,8,21,-13,6,19
D.C. United,14,0,5,9,22,29,-7,5,20
Orlando City,14,0,5,9,17,24,-7,5,21
Charlotte FC,14,0,5,9,19,31,-12,5,22
Chicago Fire,14,0,3,11,16,33,-17,3,23
Houston Dynamo,14,0,2,12,19,15,4,2,24
Sporting Kansas City,14,0,2,12,15,27,-12,2,25
Colorado Rapids,14,0,2,12,14,31,-17,2,26
Vancouver Whitecaps,14,0,1,13,15,18,-3,1,27
Toronto FC,14,0,1,13,20,30,-10,1,28
Philadelphia Union,15,15,0,0,30,14,16,45,1
Los Angeles FC,15,12,2,1,37,17,20,38,2
FC Dallas,15,10,3,2,19,20,-1,33,3
Columbus Crew,15,9,5,1,24,23,1,32,4
Austin FC,15,9,3,3,30,21,9,30,5
New York City FC,15,1,12,2,26,23,3,15,6
Los Angeles Galaxy,15,2,8,5,18,23,-5,14,7
Nashville SC,15,1,11,3,14,27,-13,14,8
Portland Timbers,15,2,7,6,20,29,-9,13,9
New York Red Bulls,15,1,10,4,20,26,-6,13,10
Inter Miami,15,2,6,7,16,28,-12,12,11
CF Montreal,15,1,9,5,30,26,4,12,12
FC Cincinnati,15,1,9,5,20,33,-13,12,13
San Jose Earthquakes,15,2,5,8,32,25,7,11,14
Orlando City,15,1,5,9,19,24,-5,8,15
Atlanta United FC,15,0,7,8,22,28,-6,7,16
Seattle Sounders,15,0,7,8,20,26,-6,7,17
Minnesota,15,0,7,8,13,22,-9,7,18
Real Salt Lake,15,0,7,8,13,22,-9,7,19
D.C. United,15,0,6,9,25,33,-8,6,20
New England Revolution,15,0,6,9,9,22,-13,6,21
Charlotte FC,15,0,5,10,20,35,-15,5,22
Chicago Fire,15,0,3,12,18,35,-17,3,23
Houston Dynamo,15,0,2,13,20,16,4,2,24
Sporting Kansas City,15,0,2,13,16,28,-12,2,25
Colorado Rapids,15,0,2,13,14,35,-21,2,26
Vancouver Whitecaps,15,0,1,14,15,18,-3,1,27
Toronto FC,15,0,1,14,22,34,-12,1,28
Philadelphia Union,16,16,0,0,33,15,18,48,1
Los Angeles FC,16,13,2,1,40,17,23,41,2
FC Dallas,16,11,3,2,21,22,-1,36,3
Columbus Crew,16,10,5,1,27,23,4,35,4
Austin FC,16,10,3,3,31,22,9,33,5
Portland Timbers,16,3,7,6,21,29,-8,16,6
New York City FC,16,1,13,2,28,24,4,16,7
Los Angeles Galaxy,16,2,9,5,21,24,-3,15,8
Nashville SC,16,1,12,3,16,27,-11,15,9
San Jose Earthquakes,16,3,5,8,34,25,9,14,10
New York Red Bulls,16,1,11,4,22,30,-8,14,11
Inter Miami,16,2,7,7,18,29,-11,13,12
CF Montreal,16,1,10,5,34,30,4,13,13
FC Cincinnati,16,1,10,5,20,33,-13,13,14
Orlando City,16,2,5,9,19,24,-5,11,15
Atlanta United FC,16,1,7,8,22,28,-6,10,16
Seattle Sounders,16,0,8,8,22,28,-6,8,17
Real Salt Lake,16,0,8,8,15,24,-9,8,18
Minnesota,16,0,8,8,14,23,-9,8,19
New England Revolution,16,0,7,9,10,24,-14,7,20
D.C. United,16,0,6,10,25,36,-11,6,21
Charlotte FC,16,0,6,10,22,37,-15,6,22
Chicago Fire,16,0,4,12,19,37,-18,4,23
Houston Dynamo,16,0,3,13,20,17,3,3,24
Sporting Kansas City,16,0,3,13,16,29,-13,3,25
Colorado Rapids,16,0,3,13,17,36,-19,3,26
Vancouver Whitecaps,16,0,1,15,15,19,-4,1,27
Toronto FC,16,0,1,15,22,39,-17,1,28
Philadelphia Union,17,17,0,0,34,16,18,51,1
Los Angeles FC,17,14,2,1,42,18,24,44,2
FC Dallas,17,12,3,2,24,24,0,39,3
Columbus Crew,17,11,5,1,28,24,4,38,4
Austin FC,17,11,3,3,36,23,13,36,5
Portland Timbers,17,4,7,6,22,32,-10,19,6
Los Angeles Galaxy,17,3,9,5,24,25,-1,18,7
New York City FC,17,1,14,2,28,28,0,17,8
Nashville SC,17,1,13,3,17,27,-10,16,9
San Jose Earthquakes,17,3,6,8,34,25,9,15,10
New York Red Bulls,17,1,12,4,23,31,-8,15,11
Orlando City,17,3,5,9,20,24,-4,14,12
Inter Miami,17,2,8,7,21,30,-9,14,13
CF Montreal,17,1,11,5,34,35,-1,14,14
FC Cincinnati,17,1,11,5,21,36,-15,14,15
Atlanta United FC,17,2,7,8,22,29,-7,13,16
Seattle Sounders,17,0,9,8,25,28,-3,9,17
Minnesota,17,0,9,8,15,23,-8,9,18
Real Salt Lake,17,0,9,8,15,26,-11,9,19
New England Revolution,17,0,8,9,10,27,-17,8,20
D.C. United,17,0,7,10,27,37,-10,7,21
Charlotte FC,17,0,7,10,22,39,-17,7,22
Chicago Fire,17,0,5,12,19,37,-18,5,23
Houston Dynamo,17,0,4,13,20,20,0,4,24
Colorado Rapids,17,0,4,13,18,38,-20,4,25
Sporting Kansas City,17,0,3,14,17,31,-14,3,26
Toronto FC,17,0,2,15,23,42,-19,2,27
Vancouver Whitecaps,17,0,1,16,17,19,-2,1,28
Philadelphia Union,18,18,0,0,37,16,21,54,1
Los Angeles FC,18,15,2,1,44,18,26,47,2
FC Dallas,18,13,3,2,26,26,0,42,3
Austin FC,18,12,3,3,38,25,13,39,4
Columbus Crew,18,11,6,1,29,25,4,39,5
Portland Timbers,18,5,7,6,26,34,-8,22,6
Los Angeles Galaxy,18,4,9,5,27,25,2,21,7
New York City FC,18,1,15,2,28,31,-3,18,8
Inter Miami,18,3,8,7,24,32,-8,17,9
Nashville SC,18,1,14,3,19,29,-10,17,10
San Jose Earthquakes,18,3,7,8,35,25,10,16,11
Atlanta United FC,18,3,7,8,22,30,-8,16,12
Orlando City,18,3,6,9,22,25,-3,15,13
New York Red Bulls,18,1,12,5,25,37,-12,15,14
CF Montreal,18,1,11,6,35,36,-1,14,15
FC Cincinnati,18,1,11,6,26,39,-13,14,16
Seattle Sounders,18,0,10,8,26,30,-4,10,17
Minnesota,18,0,9,9,16,27,-11,9,18
Real Salt Lake,18,0,9,9,15,29,-14,9,19
New England Revolution,18,0,9,9,11,28,-17,9,20
D.C. United,18,0,8,10,29,39,-10,8,21
Houston Dynamo,18,1,4,13,22,21,1,7,22
Charlotte FC,18,0,7,11,25,42,-17,7,23
Chicago Fire,18,0,5,13,19,39,-20,5,24
Sporting Kansas City,18,0,4,14,18,32,-14,4,25
Colorado Rapids,18,0,4,14,20,48,-28,4,26
Toronto FC,18,0,2,16,24,44,-20,2,27
Vancouver Whitecaps,18,0,1,17,17,21,-4,1,28
Philadelphia Union,19,19,0,0,41,16,25,57,1
Los Angeles FC,19,16,2,1,46,18,28,50,2
FC Dallas,19,14,3,2,29,27,2,45,3
Austin FC,19,13,3,3,40,27,13,42,4
Columbus Crew,19,12,6,1,32,26,6,42,5
Los Angeles Galaxy,19,5,9,5,29,26,3,24,6
Portland Timbers,19,5,8,6,27,38,-11,23,7
San Jose Earthquakes,19,4,7,8,36,26,10,19,8
New York City FC,19,1,16,2,29,31,-2,19,9
Inter Miami,19,3,9,7,25,33,-8,18,10
Nashville SC,19,1,15,3,19,30,-11,18,11
Atlanta United FC,19,3,8,8,23,30,-7,17,12
CF Montreal,19,2,11,6,37,39,-2,17,13
Orlando City,19,3,7,9,22,26,-4,16,14
New York Red Bulls,19,1,13,5,26,38,-12,16,15
FC Cincinnati,19,1,12,6,28,40,-12,15,16
Seattle Sounders,19,1,10,8,27,31,-4,13,17
Minnesota,19,0,10,9,17,28,-11,10,18
New England Revolution,19,0,10,9,13,28,-15,10,19
Real Salt Lake,19,0,10,9,15,32,-17,10,20
D.C. United,19,0,9,10,29,39,-10,9,21
Houston Dynamo,19,1,5,13,27,22,5,8,22
Charlotte FC,19,0,8,11,26,42,-16,8,23
Chicago Fire,19,0,5,14,19,40,-21,5,24
Colorado Rapids,19,0,5,14,20,48,-28,5,25
Sporting Kansas City,19,0,4,15,19,32,-13,4,26
Toronto FC,19,0,3,16,25,44,-19,3,27
Vancouver Whitecaps,19,0,1,18,18,21,-3,1,28
Philadelphia Union,20,20,0,0,46,17,29,60,1
Los Angeles FC,20,17,2,1,49,19,30,53,2
FC Dallas,20,15,3,2,30,30,0,48,3
Austin FC,20,14,3,3,43,29,14,45,4
Columbus Crew,20,13,6,1,33,28,5,45,5
Los Angeles Galaxy,20,6,9,5,32,29,3,27,6
Portland Timbers,20,6,8,6,27,41,-14,26,7
San Jose Earthquakes,20,4,8,8,38,27,11,20,8
Atlanta United FC,20,4,8,8,26,31,-5,20,9
New York City FC,20,1,17,2,29,31,-2,20,10
Inter Miami,20,3,10,7,26,34,-8,19,11
Nashville SC,20,1,16,3,20,32,-12,19,12
CF Montreal,20,2,12,6,42,43,-1,18,13
Orlando City,20,3,8,9,23,28,-5,17,14
New York Red Bulls,20,1,14,5,26,39,-13,17,15
Seattle Sounders,20,2,10,8,30,31,-1,16,16
FC Cincinnati,20,1,13,6,30,40,-10,16,17
New England Revolution,20,1,10,9,15,29,-14,13,18
Houston Dynamo,20,2,5,13,29,25,4,11,19
Minnesota,20,0,11,9,18,31,-13,11,20
Real Salt Lake,20,0,11,9,17,34,-17,11,21
D.C. United,20,0,10,10,29,39,-10,10,22
Charlotte FC,20,0,9,11,28,44,-16,9,23
Chicago Fire,20,0,6,14,20,41,-21,6,24
Sporting Kansas City,20,0,5,15,19,33,-14,5,25
Colorado Rapids,20,0,5,15,20,49,-29,5,26
Toronto FC,20,0,4,16,26,44,-18,4,27
Vancouver Whitecaps,20,0,1,19,21,23,-2,1,28
Philadelphia Union,21,21,0,0,46,17,29,63,1
Los Angeles FC,21,18,2,1,53,20,33,56,2
FC Dallas,21,16,3,2,33,32,1,51,3
Austin FC,21,15,3,3,44,30,14,48,4
Columbus Crew,21,13,7,1,36,28,8,46,5
Los Angeles Galaxy,21,7,9,5,35,29,6,30,6
Portland Timbers,21,7,8,6,29,42,-13,29,7
Inter Miami,21,4,10,7,27,34,-7,22,8
San Jose Earthquakes,21,4,9,8,39,28,11,21,9
Atlanta United FC,21,4,9,8,28,34,-6,21,10
New York City FC,21,1,18,2,30,33,-3,21,11
Orlando City,21,4,8,9,24,28,-4,20,12
Nashville SC,21,1,17,3,21,37,-16,20,13
Seattle Sounders,21,3,10,8,31,32,-1,19,14
CF Montreal,21,2,13,6,44,44,0,19,15
New York Red Bulls,21,1,14,6,26,40,-14,17,16
New England Revolution,21,2,10,9,18,29,-11,16,17
FC Cincinnati,21,1,13,7,30,42,-12,16,18
Houston Dynamo,21,2,6,13,31,26,5,12,19
D.C. United,21,0,11,10,30,40,-10,11,20
Minnesota,21,0,11,10,19,31,-12,11,21
Real Salt Lake,21,0,11,10,19,40,-21,11,22
Charlotte FC,21,0,9,12,28,46,-18,9,23
Toronto FC,21,1,4,16,31,44,-13,7,24
Sporting Kansas City,21,0,6,15,22,37,-15,6,25
Chicago Fire,21,0,6,15,20,44,-24,6,26
Colorado Rapids,21,0,6,15,20,50,-30,6,27
Vancouver Whitecaps,21,0,1,20,23,28,-5,1,28
Philadelphia Union,22,22,0,0,48,18,30,66,1
Los Angeles FC,22,19,2,1,60,20,40,59,2
FC Dallas,22,17,3,2,34,33,1,54,3
Austin FC,22,16,3,3,45,30,15,51,4
Columbus Crew,22,14,7,1,37,28,9,49,5
Los Angeles Galaxy,22,8,9,5,38,30,8,33,6
Portland Timbers,22,8,8,6,30,43,-13,32,7
Inter Miami,22,5,10,7,28,37,-9,25,8
San Jose Earthquakes,22,5,9,8,41,32,9,24,9
Atlanta United FC,22,5,9,8,30,35,-5,24,10
Seattle Sounders,22,4,10,8,31,34,-3,22,11
CF Montreal,22,3,13,6,45,45,0,22,12
New York City FC,22,1,19,2,31,38,-7,22,13
Orlando City,22,4,9,9,25,29,-4,21,14
Nashville SC,22,1,18,3,22,38,-16,21,15
New England Revolution,22,3,10,9,19,34,-15,19,16
FC Cincinnati,22,2,13,7,30,44,-14,19,17
New York Red Bulls,22,1,15,6,28,42,-14,18,18
Houston Dynamo,22,2,7,13,32,27,5,13,19
D.C. United,22,0,11,11,31,45,-14,11,20
Minnesota,22,0,11,11,20,36,-16,11,21
Real Salt Lake,22,0,11,11,22,40,-18,11,22
Sporting Kansas City,22,1,6,15,24,38,-14,9,23
Charlotte FC,22,0,9,13,30,47,-17,9,24
Toronto FC,22,1,5,16,32,44,-12,8,25
Chicago Fire,22,0,7,15,21,44,-23,7,26
Colorado Rapids,22,0,6,16,21,52,-31,6,27
Vancouver Whitecaps,22,0,1,21,25,30,-5,1,28
Philadelphia Union,23,23,0,0,49,18,31,69,1
Los Angeles FC,23,20,2,1,63,20,43,62,2
FC Dallas,23,18,3,2,34,33,1,57,3
Austin FC,23,17,3,3,47,31,16,54,4
Columbus Crew,23,15,7,1,40,29,11,52,5
Los Angeles Galaxy,23,9,9,5,38,35,3,36,6
Portland Timbers,23,9,8,6,33,43,-10,35,7
San Jose Earthquakes,23,6,9,8,41,33,8,27,8
Inter Miami,23,5,11,7,30,38,-8,26,9
Seattle Sounders,23,5,10,8,33,36,-3,25,10
Atlanta United FC,23,5,10,8,32,35,-3,25,11
CF Montreal,23,4,13,6,48,45,3,25,12
New York City FC,23,1,20,2,32,40,-8,23,13
Orlando City,23,4,10,9,28,29,-1,22,14
Nashville SC,23,1,19,3,22,40,-18,22,15
New England Revolution,23,3,11,9,21,36,-15,20,16
FC Cincinnati,23,2,14,7,31,45,-14,20,17
New York Red Bulls,23,1,16,6,29,44,-15,19,18
Houston Dynamo,23,2,8,13,32,28,4,14,19
D.C. United,23,0,12,11,33,48,-15,12,20
Minnesota,23,0,12,11,20,37,-17,12,21
Toronto FC,23,2,5,16,36,46,-10,11,22
Real Salt Lake,23,0,11,12,22,42,-20,11,23
Sporting Kansas City,23,1,7,15,24,38,-14,10,24
Charlotte FC,23,0,9,14,31,47,-16,9,25
Chicago Fire,23,0,8,15,23,46,-23,8,26
Colorado Rapids,23,0,7,16,24,56,-32,7,27
Vancouver Whitecaps,23,0,1,22,26,31,-5,1,28
Philadelphia Union,24,24,0,0,50,19,31,72,1
Los Angeles FC,24,21,2,1,67,21,46,65,2
FC Dallas,24,19,3,2,34,35,-1,60,3
Austin FC,24,18,3,3,50,34,16,57,4
Columbus Crew,24,16,7,1,41,30,11,55,5
Los Angeles Galaxy,24,10,9,5,41,37,4,39,6
Portland Timbers,24,10,8,6,37,43,-6,38,7
Inter Miami,24,6,11,7,32,38,-6,29,8
San Jose Earthquakes,24,6,10,8,45,33,12,28,9
Seattle Sounders,24,6,10,8,33,36,-3,28,10
CF Montreal,24,5,13,6,52,47,5,28,11
Atlanta United FC,24,5,11,8,34,35,-1,26,12
Orlando City,24,5,10,9,30,30,0,25,13
New York City FC,24,1,21,2,34,40,-6,24,14
New England Revolution,24,4,11,9,21,37,-16,23,15
Nashville SC,24,1,20,3,25,41,-16,23,16
FC Cincinnati,24,2,15,7,33,48,-15,21,17
New York Red Bulls,24,1,17,6,30,46,-16,20,18
Houston Dynamo,24,2,9,13,32,29,3,15,19
Sporting Kansas City,24,2,7,15,28,41,-13,13,20
D.C. United,24,0,13,11,35,49,-14,13,21
Minnesota,24,0,13,11,23,41,-18,13,22
Toronto FC,24,2,6,16,38,48,-10,12,23
Real Salt Lake,24,0,12,12,23,42,-19,12,24
Chicago Fire,24,1,8,15,28,47,-19,11,25
Charlotte FC,24,0,10,14,33,48,-15,10,26
Colorado Rapids,24,0,8,16,28,57,-29,8,27
Vancouver Whitecaps,24,0,1,23,26,35,-9,1,28
Philadelphia Union,25,25,0,0,51,20,31,75,1
Los Angeles FC,25,22,2,1,69,21,48,68,2
FC Dallas,25,20,3,2,34,35,-1,63,3
Austin FC,25,19,3,3,52,34,18,60,4
Columbus Crew,25,17,7,1,42,31,11,58,5
Los Angeles Galaxy,25,11,9,5,43,37,6,42,6
Portland Timbers,25,10,9,6,38,46,-8,39,7
Inter Miami,25,7,11,7,36,38,-2,32,8
San Jose Earthquakes,25,7,10,8,49,33,16,31,9
CF Montreal,25,6,13,6,61,48,13,31,10
Atlanta United FC,25,6,11,8,34,36,-2,29,11
Seattle Sounders,25,6,11,8,34,37,-3,29,12
Orlando City,25,6,10,9,30,31,-1,28,13
New England Revolution,25,5,11,9,22,39,-17,26,14
New York City FC,25,1,22,2,34,40,-6,25,15
FC Cincinnati,25,3,15,7,35,50,-15,24,16
Nashville SC,25,1,21,3,25,42,-17,24,17
New York Red Bulls,25,1,18,6,30,47,-17,21,18
Houston Dynamo,25,2,10,13,32,31,1,16,19
Sporting Kansas City,25,2,8,15,31,42,-11,14,20
Minnesota,25,0,14,11,24,43,-19,14,21
Toronto FC,25,2,7,16,39,52,-13,13,22
D.C. United,25,0,13,12,36,53,-17,13,23
Real Salt Lake,25,0,13,12,24,48,-24,13,24
Chicago Fire,25,1,9,15,29,48,-19,12,25
Colorado Rapids,25,1,8,16,30,58,-28,11,26
Charlotte FC,25,0,10,15,33,48,-15,10,27
Vancouver Whitecaps,25,0,2,23,26,38,-12,2,28
Philadelphia Union,26,26,0,0,52,21,31,78,1
Los Angeles FC,26,23,2,1,71,21,50,71,2
FC Dallas,26,21,3,2,36,36,0,66,3
Austin FC,26,20,3,3,55,35,20,63,4
Columbus Crew,26,17,8,1,43,33,10,59,5
Los Angeles Galaxy,26,12,9,5,48,40,8,45,6
Portland Timbers,26,11,9,6,40,47,-7,42,7
San Jose Earthquakes,26,8,10,8,51,34,17,34,8
CF Montreal,26,7,13,6,61,48,13,34,9
Inter Miami,26,7,12,7,37,40,-3,33,10
Atlanta United FC,26,7,11,8,36,38,-2,32,11
Seattle Sounders,26,7,11,8,35,37,-2,32,12
Orlando City,26,6,11,9,31,35,-4,29,13
New England Revolution,26,5,12,9,23,39,-16,27,14
FC Cincinnati,26,4,15,7,42,50,-8,27,15
New York City FC,26,1,23,2,35,42,-7,26,16
Nashville SC,26,1,21,4,26,43,-17,24,17
New York Red Bulls,26,1,18,7,31,48,-17,21,18
Houston Dynamo,26,2,11,13,32,32,0,17,19
Sporting Kansas City,26,2,9,15,32,43,-11,15,20
Chicago Fire,26,2,9,15,29,49,-20,15,21
Minnesota,26,0,15,11,27,44,-17,15,22
Toronto FC,26,2,8,16,41,54,-13,14,23
Colorado Rapids,26,2,8,16,34,60,-26,14,24
D.C. United,26,0,14,12,39,55,-16,14,25
Real Salt Lake,26,0,14,12,24,50,-26,14,26
Charlotte FC,26,0,11,15,36,50,-14,11,27
Vancouver Whitecaps,26,0,2,24,28,41,-13,2,28
Philadelphia Union,27,27,0,0,53,23,30,81,1
Los Angeles FC,27,24,2,1,76,21,55,74,2
FC Dallas,27,22,3,2,37,39,-2,69,3
Austin FC,27,21,3,3,55,38,17,66,4
Columbus Crew,27,17,9,1,45,33,12,60,5
Los Angeles Galaxy,27,13,9,5,50,41,9,48,6
Portland Timbers,27,12,9,6,43,48,-5,45,7
CF Montreal,27,8,13,6,63,48,15,37,8
San Jose Earthquakes,27,8,11,8,55,34,21,35,9
Seattle Sounders,27,8,11,8,37,37,0,35,10
Inter Miami,27,7,13,7,39,41,-2,34,11
Atlanta United FC,27,7,12,8,38,41,-3,33,12
Orlando City,27,6,12,9,31,36,-5,30,13
New England Revolution,27,6,12,9,25,41,-16,30,14
FC Cincinnati,27,5,15,7,46,53,-7,30,15
New York City FC,27,2,23,2,40,43,-3,29,16
Nashville SC,27,1,22,4,26,43,-17,25,17
New York Red Bulls,27,1,19,7,33,49,-16,22,18
Houston Dynamo,27,3,11,13,33,35,-2,20,19
Minnesota,27,1,15,11,28,45,-17,18,20
Colorado Rapids,27,3,8,16,35,61,-26,17,21
Sporting Kansas City,27,2,10,15,36,45,-9,16,22
Chicago Fire,27,2,10,15,31,52,-21,16,23
Toronto FC,27,2,9,16,43,56,-13,15,24
D.C. United,27,0,15,12,40,55,-15,15,25
Real Salt Lake,27,0,15,12,25,52,-27,15,26
Charlotte FC,27,0,11,16,37,53,-16,11,27
Vancouver Whitecaps,27,0,3,24,29,41,-12,3,28
Philadelphia Union,28,27,1,0,57,25,32,82,1
Los Angeles FC,28,25,2,1,79,21,58,77,2
FC Dallas,28,22,4,2,37,40,-3,70,3
Austin FC,28,22,3,3,58,38,20,69,4
Columbus Crew,28,17,10,1,46,33,13,61,5
Los Angeles Galaxy,28,14,9,5,52,41,11,51,6
Portland Timbers,28,12,10,6,45,49,-4,46,7
CF Montreal,28,9,13,6,69,48,21,40,8
Seattle Sounders,28,9,11,8,38,39,-1,38,9
San Jose Earthquakes,28,8,12,8,56,34,22,36,10
Atlanta United FC,28,8,12,8,40,42,-2,36,11
Inter Miami,28,7,14,7,39,41,-2,35,12
Orlando City,28,7,12,9,32,39,-7,33,13
FC Cincinnati,28,6,15,7,47,54,-7,33,14
New England Revolution,28,6,13,9,26,42,-16,31,15
New York City FC,28,2,24,2,43,43,0,30,16
Nashville SC,28,1,23,4,28,44,-16,26,17
New York Red Bulls,28,1,20,7,35,51,-16,23,18
Houston Dynamo,28,3,12,13,35,36,-1,21,19
Minnesota,28,2,15,11,30,48,-18,21,20
Toronto FC,28,3,9,16,47,56,-9,18,21
Colorado Rapids,28,3,9,16,35,62,-27,18,22
Real Salt Lake,28,1,15,12,28,53,-25,18,23
Sporting Kansas City,28,2,11,15,36,45,-9,17,24
Chicago Fire,28,2,11,15,32,54,-22,17,25
D.C. United,28,0,16,12,40,57,-17,16,26
Charlotte FC,28,0,12,16,38,53,-15,12,27
Vancouver Whitecaps,28,0,4,24,31,41,-10,4,28
Philadelphia Union,29,27,2,0,59,25,34,83,1
Los Angeles FC,29,26,2,1,85,21,64,80,2
FC Dallas,29,23,4,2,38,40,-2,73,3
Austin FC,29,22,4,3,59,39,20,70,4
Columbus Crew,29,17,10,2,47,37,10,61,5
Los Angeles Galaxy,29,15,9,5,55,43,12,54,6
Portland Timbers,29,13,10,6,46,49,-3,49,7
CF Montreal,29,10,13,6,73,49,24,43,8
Seattle Sounders,29,10,11,8,41,39,2,41,9
Atlanta United FC,29,9,12,8,40,43,-3,39,10
Inter Miami,29,8,14,7,42,43,-1,38,11
San Jose Earthquakes,29,8,13,8,57,34,23,37,12
FC Cincinnati,29,7,15,7,49,55,-6,36,13
Orlando City,29,7,13,9,33,40,-7,34,14
New England Revolution,29,7,13,9,30,44,-14,34,15
New York City FC,29,3,24,2,43,45,-2,33,16
Nashville SC,29,2,23,4,29,46,-17,29,17
Minnesota,29,3,15,11,31,48,-17,24,18
New York Red Bulls,29,1,21,7,36,52,-16,24,19
Houston Dynamo,29,3,13,13,40,38,2,22,20
Colorado Rapids,29,4,9,16,35,63,-28,21,21
Real Salt Lake,29,2,15,12,28,55,-27,21,22
Sporting Kansas City,29,3,11,15,36,50,-14,20,23
Toronto FC,29,3,10,16,48,59,-11,19,24
Chicago Fire,29,2,12,15,33,55,-22,18,25
D.C. United,29,0,17,12,42,60,-18,17,26
Charlotte FC,29,0,13,16,39,56,-17,13,27
Vancouver Whitecaps,29,1,4,24,33,42,-9,7,28
Philadelphia Union,30,27,3,0,63,26,37,84,1
Los Angeles FC,30,26,3,1,87,21,66,81,2
FC Dallas,30,23,5,2,39,42,-3,74,3
Austin FC,30,23,4,3,62,41,21,73,4
Columbus Crew,30,17,10,3,48,37,11,61,5
Los Angeles Galaxy,30,16,9,5,56,44,12,57,6
Portland Timbers,30,14,10,6,48,49,-1,52,7
CF Montreal,30,11,13,6,75,50,25,46,8
Seattle Sounders,30,10,12,8,42,42,0,42,9
San Jose Earthquakes,30,9,13,8,59,34,25,40,10
Atlanta United FC,30,9,13,8,41,45,-4,40,11
Inter Miami,30,8,15,7,44,45,-1,39,12
FC Cincinnati,30,8,15,7,53,55,-2,39,13
New England Revolution,30,8,13,9,31,45,-14,37,14
New York City FC,30,4,24,2,43,47,-4,36,15
Orlando City,30,7,14,9,33,42,-9,35,16
Nashville SC,30,2,24,4,30,46,-16,30,17
Minnesota,30,4,15,11,33,49,-16,27,18
New York Red Bulls,30,1,22,7,37,52,-15,25,19
Real Salt Lake,30,3,15,12,32,57,-25,24,20
Houston Dynamo,30,3,14,13,42,39,3,23,21
Colorado Rapids,30,4,10,16,35,63,-28,22,22
Sporting Kansas City,30,3,12,15,37,52,-15,21,23
Toronto FC,30,3,11,16,51,62,-11,20,24
Chicago Fire,30,2,13,15,37,57,-20,19,25
D.C. United,30,0,17,13,44,62,-18,17,26
Charlotte FC,30,1,13,16,41,58,-17,16,27
Vancouver Whitecaps,30,1,5,24,34,44,-10,8,28
Philadelphia Union,31,27,4,0,65,27,38,85,1
Los Angeles FC,31,26,4,1,90,24,66,82,2
Austin FC,31,24,4,3,62,41,21,76,3
FC Dallas,31,23,5,3,39,44,-5,74,4
Columbus Crew,31,17,10,4,51,39,12,61,5
Los Angeles Galaxy,31,17,9,5,57,44,13,60,6
Portland Timbers,31,15,10,6,50,51,-1,55,7
CF Montreal,31,12,13,6,78,52,26,49,8
Seattle Sounders,31,11,12,8,45,45,0,45,9
FC Cincinnati,31,9,15,7,54,57,-3,42,10
San Jose Earthquakes,31,9,14,8,62,37,25,41,11
Atlanta United FC,31,9,14,8,41,45,-4,41,12
Inter Miami,31,8,16,7,45,47,-2,40,13
New York City FC,31,5,24,2,44,47,-3,39,14
New England Revolution,31,8,14,9,32,48,-16,38,15
Orlando City,31,7,15,9,34,43,-9,36,16
Nashville SC,31,2,25,4,33,47,-14,31,17
Minnesota,31,5,15,11,34,53,-19,30,18
New York Red Bulls,31,1,23,7,39,52,-13,26,19
Real Salt Lake,31,3,16,12,33,58,-25,25,20
Houston Dynamo,31,3,15,13,44,39,5,24,21
Colorado Rapids,31,4,11,16,38,65,-27,23,22
Sporting Kansas City,31,3,13,15,38,53,-15,22,23
Toronto FC,31,3,12,16,52,62,-10,21,24
Chicago Fire,31,2,14,15,38,57,-19,20,25
Charlotte FC,31,2,13,16,42,59,-17,19,26
D.C. United,31,0,17,14,44,65,-21,17,27
Vancouver Whitecaps,31,1,6,24,36,44,-8,9,28
Philadelphia Union,32,28,4,0,67,28,39,88,1
Los Angeles FC,32,27,4,1,91,26,65,85,2
Austin FC,32,25,4,3,63,41,22,79,3
FC Dallas,32,24,5,3,39,47,-8,77,4
Los Angeles Galaxy,32,18,9,5,58,45,13,63,5
Columbus Crew,32,17,11,4,51,41,10,62,6
Portland Timbers,32,16,10,6,53,52,1,58,7
CF Montreal,32,13,13,6,80,52,28,52,8
Seattle Sounders,32,12,12,8,49,46,3,48,9
FC Cincinnati,32,10,15,7,57,57,0,45,10
San Jose Earthquakes,32,9,15,8,65,40,25,42,11
Atlanta United FC,32,9,15,8,42,48,-6,42,12
New York City FC,32,6,24,2,47,48,-1,42,13
New England Revolution,32,9,14,9,34,50,-16,41,14
Inter Miami,32,8,17,7,45,49,-4,41,15
Orlando City,32,8,15,9,36,43,-7,39,16
Nashville SC,32,3,25,4,35,50,-15,34,17
Minnesota,32,6,15,11,36,53,-17,33,18
New York Red Bulls,32,2,23,7,42,52,-10,29,19
Real Salt Lake,32,4,16,12,34,60,-26,28,20
Colorado Rapids,32,5,11,16,41,65,-24,26,21
Sporting Kansas City,32,4,13,15,39,54,-15,25,22
Houston Dynamo,32,3,16,13,45,41,4,25,23
Toronto FC,32,3,13,16,56,66,-10,22,24
Charlotte FC,32,3,13,16,44,61,-17,22,25
Chicago Fire,32,2,15,15,38,58,-20,21,26
D.C. United,32,0,17,15,46,67,-21,17,27
Vancouver Whitecaps,32,1,7,24,36,45,-9,10,28
Philadelphia Union,33,29,4,0,68,28,40,91,1
Los Angeles FC,33,28,4,1,95,28,67,88,2
Austin FC,33,25,5,3,64,41,23,80,3
FC Dallas,33,24,6,3,40,47,-7,78,4
Los Angeles Galaxy,33,19,9,5,60,45,15,66,5
Columbus Crew,33,17,12,4,54,42,12,63,6
Portland Timbers,33,16,11,6,54,53,1,59,7
CF Montreal,33,14,13,6,83,53,30,55,8
Seattle Sounders,33,12,13,8,49,46,3,49,9
FC Cincinnati,33,11,15,7,62,58,4,48,10
Atlanta United FC,33,10,15,8,43,51,-8,45,11
New York City FC,33,7,24,2,49,49,0,45,12
New England Revolution,33,10,14,9,38,50,-12,44,13
San Jose Earthquakes,33,9,16,8,66,43,23,43,14
Inter Miami,33,8,18,7,46,49,-3,42,15
Orlando City,33,8,16,9,36,44,-8,40,16
Nashville SC,33,4,25,4,37,50,-13,37,17
Minnesota,33,6,16,11,37,53,-16,34,18
New York Red Bulls,33,3,23,7,45,54,-9,32,19
Real Salt Lake,33,5,16,12,36,61,-25,31,20
Colorado Rapids,33,5,12,16,44,65,-21,27,21
Sporting Kansas City,33,4,14,15,44,54,-10,26,22
Houston Dynamo,33,3,17,13,47,42,5,26,23
Toronto FC,33,3,14,16,58,67,-9,23,24
Charlotte FC,33,3,14,16,48,62,-14,23,25
Chicago Fire,33,2,16,15,40,59,-19,22,26
D.C. United,33,0,17,16,46,68,-22,17,27
Vancouver Whitecaps,33,1,8,24,38,45,-7,11,28
Philadelphia Union,34,30,4,0,69,30,39,94,1
Los Angeles FC,34,29,4,1,96,31,65,91,2
Austin FC,34,25,6,3,66,44,22,81,3
FC Dallas,34,24,7,3,42,53,-11,79,4
Los Angeles Galaxy,34,20,9,5,60,45,15,69,5
Columbus Crew,34,17,13,4,57,43,14,64,6
Portland Timbers,34,16,12,6,55,55,0,60,7
CF Montreal,34,15,13,6,84,54,30,58,8
Seattle Sounders,34,13,13,8,50,47,3,52,9
FC Cincinnati,34,12,15,7,63,59,4,51,10
Atlanta United FC,34,11,15,8,45,51,-6,48,11
New York City FC,34,8,24,2,51,50,1,48,12
New England Revolution,34,10,15,9,41,54,-13,45,13
San Jose Earthquakes,34,9,17,8,68,43,25,44,14
Inter Miami,34,8,18,8,47,51,-4,42,15
Orlando City,34,8,17,9,37,46,-9,41,16
Nashville SC,34,5,25,4,39,51,-12,40,17
Minnesota,34,7,16,11,38,53,-15,37,18
New York Red Bulls,34,4,23,7,48,54,-6,35,19
Real Salt Lake,34,5,17,12,38,61,-23,32,20
Colorado Rapids,34,5,13,16,47,66,-19,28,21
Sporting Kansas City,34,4,15,15,44,54,-10,27,22
Houston Dynamo,34,3,18,13,48,44,4,27,23
Charlotte FC,34,4,14,16,49,64,-15,26,24
Chicago Fire,34,3,16,15,41,63,-22,25,25
Toronto FC,34,3,15,16,59,70,-11,24,26
D.C. United,34,0,17,17,48,69,-21,17,27
Vancouver Whitecaps,34,1,9,24,39,45,-6,12,28
Philadelphia Union,35,31,4,0,71,32,39,97,1
Los Angeles FC,35,29,5,1,98,31,67,92,2
Austin FC,35,25,7,3,69,44,25,82,3
FC Dallas,35,24,8,3,45,54,-9,80,4
Los Angeles Galaxy,35,21,9,5,64,46,18,72,5
Columbus Crew,35,17,14,4,57,47,10,65,6
CF Montreal,35,16,13,6,86,54,32,61,7
Portland Timbers,35,16,13,6,58,56,2,61,8
Seattle Sounders,35,14,13,8,51,49,2,55,9
FC Cincinnati,35,13,15,7,63,60,3,54,10
New York City FC,35,9,24,2,54,50,4,51,11
Atlanta United FC,35,11,16,8,47,52,-5,49,12
New England Revolution,35,10,16,9,46,57,-11,46,13
San Jose Earthquakes,35,9,17,9,68,44,24,44,14
Nashville SC,35,6,25,4,43,54,-11,43,15
Inter Miami,35,8,18,9,47,52,-5,42,16
Orlando City,35,8,18,9,39,47,-8,42,17
Minnesota,35,7,17,11,39,55,-16,38,18
New York Red Bulls,35,5,23,7,50,59,-9,38,19
Real Salt Lake,35,6,17,12,38,61,-23,35,20
Colorado Rapids,35,6,13,16,49,66,-17,31,21
Houston Dynamo,35,4,18,13,49,45,4,30,22
Sporting Kansas City,35,4,16,15,46,55,-9,28,23
Charlotte FC,35,4,15,16,49,64,-15,27,24
Chicago Fire,35,3,17,15,43,65,-22,26,25
Toronto FC,35,3,16,16,59,70,-11,25,26
D.C. United,35,0,17,18,49,71,-22,17,27
Vancouver Whitecaps,35,1,10,24,41,47,-6,13,28
Philadelphia Union,36,32,4,0,71,32,39,100,1
Los Angeles FC,36,30,5,1,101,31,70,95,2
Austin FC,36,25,8,3,70,45,25,83,3
FC Dallas,36,24,9,3,46,57,-11,81,4
Los Angeles Galaxy,36,21,10,5,65,48,17,73,5
Columbus Crew,36,17,15,4,59,48,11,66,6
CF Montreal,36,17,13,6,96,56,40,64,7
Portland Timbers,36,16,14,6,59,58,1,62,8
Seattle Sounders,36,15,13,8,52,49,3,58,9
FC Cincinnati,36,14,15,7,69,65,4,57,10
New York City FC,36,10,24,2,55,51,4,54,11
Atlanta United FC,36,11,17,8,50,54,-4,50,12
New England Revolution,36,10,17,9,46,58,-12,47,13
Nashville SC,36,7,25,4,46,57,-11,46,14
San Jose Earthquakes,36,9,17,10,68,45,23,44,15
Orlando City,36,8,19,9,42,48,-6,43,16
Inter Miami,36,8,18,10,47,52,-5,42,17
Minnesota,36,8,17,11,40,55,-15,41,18
New York Red Bulls,36,6,23,7,55,59,-4,41,19
Real Salt Lake,36,6,18,12,41,62,-21,36,20
Colorado Rapids,36,7,13,16,50,66,-16,34,21
Houston Dynamo,36,4,19,13,54,46,8,31,22
Sporting Kansas City,36,4,17,15,49,56,-7,29,23
Charlotte FC,36,4,16,16,52,66,-14,28,24
Chicago Fire,36,3,18,15,43,68,-25,27,25
Toronto FC,36,3,17,16,60,71,-11,26,26
D.C. United,36,0,17,19,49,73,-24,17,27
Vancouver Whitecaps,36,1,11,24,43,48,-5,14,28
Philadelphia Union,37,33,4,0,72,32,40,103,1
Los Angeles FC,37,31,5,1,104,33,71,98,2
Austin FC,37,25,9,3,73,48,25,84,3
FC Dallas,37,24,10,3,47,59,-12,82,4
Los Angeles Galaxy,37,21,11,5,69,48,21,74,5
CF Montreal,37,18,13,6,99,61,38,67,6
Columbus Crew,37,17,16,4,59,53,6,67,7
Portland Timbers,37,16,15,6,59,59,0,63,8
Seattle Sounders,37,16,13,8,54,51,3,61,9
FC Cincinnati,37,15,15,7,69,66,3,60,10
New York City FC,37,11,24,2,56,54,2,57,11
Atlanta United FC,37,11,18,8,51,55,-4,51,12
New England Revolution,37,11,17,9,46,58,-12,50,13
Nashville SC,37,8,25,4,47,58,-11,49,14
San Jose Earthquakes,37,9,17,11,69,45,24,44,15
Minnesota,37,9,17,11,42,55,-13,44,16
New York Red Bulls,37,7,23,7,60,59,1,44,17
Orlando City,37,8,19,10,43,51,-8,43,18
Inter Miami,37,8,18,11,48,52,-4,42,19
Real Salt Lake,37,6,19,12,43,64,-21,37,20
Colorado Rapids,37,7,14,16,52,66,-14,35,21
Houston Dynamo,37,4,20,13,56,48,8,32,22
Charlotte FC,37,5,16,16,54,69,-15,31,23
Sporting Kansas City,37,4,18,15,49,57,-8,30,24
Chicago Fire,37,3,19,15,43,68,-25,28,25
Toronto FC,37,3,18,16,62,73,-11,27,26
D.C. United,37,0,17,20,49,73,-24,17,27
Vancouver Whitecaps,37,1,12,24,45,51,-6,15,28
Philadelphia Union,38,34,4,0,74,32,42,106,1
Los Angeles FC,38,31,6,1,108,34,74,99,2
Austin FC,38,25,10,3,74,51,23,85,3
FC Dallas,38,24,11,3,48,59,-11,83,4
Los Angeles Galaxy,38,21,12,5,72,48,24,75,5
CF Montreal,38,19,13,6,103,62,41,70,6
Columbus Crew,38,17,16,5,59,54,5,67,7
FC Cincinnati,38,16,15,7,72,68,4,63,8
Portland Timbers,38,16,15,7,62,62,0,63,9
Seattle Sounders,38,16,14,8,55,54,1,62,10
New York City FC,38,12,24,2,57,55,2,60,11
New England Revolution,38,12,17,9,50,59,-9,53,12
Nashville SC,38,9,25,4,47,59,-12,52,13
Atlanta United FC,38,11,18,9,52,58,-6,51,14
Minnesota,38,10,17,11,45,57,-12,47,15
New York Red Bulls,38,8,23,7,61,59,2,47,16
San Jose Earthquakes,38,9,17,12,70,47,23,44,17
Orlando City,38,8,19,11,43,54,-11,43,18
Inter Miami,38,8,18,12,48,55,-7,42,19
Real Salt Lake,38,7,19,12,44,65,-21,40,20
Colorado Rapids,38,8,14,16,52,67,-15,38,21
Houston Dynamo,38,4,21,13,58,49,9,33,22
Charlotte FC,38,5,17,16,56,69,-13,32,23
Sporting Kansas City,38,4,19,15,51,57,-6,31,24
Toronto FC,38,4,18,16,63,73,-10,30,25
Chicago Fire,38,3,20,15,44,70,-26,29,26
D.C. United,38,0,17,21,50,76,-26,17,27
Vancouver Whitecaps,38,1,13,24,49,53,-4,16,28
Philadelphia Union,39,35,4,0,76,33,43,109,1
Los Angeles FC,39,32,6,1,109,35,74,102,2
Austin FC,39,25,11,3,77,51,26,86,3
FC Dallas,39,24,12,3,49,59,-10,84,4
Los Angeles Galaxy,39,21,13,5,73,48,25,76,5
CF Montreal,39,20,13,6,106,62,44,73,6
Columbus Crew,39,17,17,5,59,55,4,68,7
FC Cincinnati,39,17,15,7,72,69,3,66,8
Portland Timbers,39,16,16,7,63,64,-1,64,9
Seattle Sounders,39,16,15,8,56,55,1,63,10
New York City FC,39,13,24,2,59,56,3,63,11
Nashville SC,39,10,25,4,48,60,-12,55,12
New England Revolution,39,12,18,9,51,62,-11,54,13
Atlanta United FC,39,11,19,9,53,58,-5,52,14
New York Red Bulls,39,9,23,7,62,60,2,50,15
Minnesota,39,10,18,11,46,57,-11,48,16
San Jose Earthquakes,39,9,17,13,73,49,24,44,17
Orlando City,39,8,20,11,44,55,-11,44,18
Inter Miami,39,8,19,12,49,60,-11,43,19
Real Salt Lake,39,8,19,12,45,65,-20,43,20
Colorado Rapids,39,8,15,16,52,69,-17,39,21
Sporting Kansas City,39,5,19,15,51,59,-8,34,22
Houston Dynamo,39,4,22,13,58,53,5,34,23
Charlotte FC,39,5,18,16,56,71,-15,33,24
Toronto FC,39,4,19,16,65,75,-10,31,25
Chicago Fire,39,3,21,15,45,71,-26,30,26
Vancouver Whitecaps,39,2,13,24,49,57,-8,19,27
D.C. United,39,0,17,22,51,78,-27,17,28
Philadelphia Union,40,36,4,0,76,35,41,112,1
Los Angeles FC,40,32,7,1,111,37,74,103,2
Austin FC,40,25,12,3,79,52,27,87,3
FC Dallas,40,24,13,3,49,62,-13,85,4
Los Angeles Galaxy,40,21,14,5,74,49,25,77,5
CF Montreal,40,21,13,6,108,62,46,76,6
FC Cincinnati,40,18,15,7,74,69,5,69,7
Columbus Crew,40,17,18,5,60,58,2,69,8
New York City FC,40,14,24,2,61,57,4,66,9
Seattle Sounders,40,16,16,8,58,55,3,64,10
Portland Timbers,40,16,16,8,65,64,1,64,11
Nashville SC,40,11,25,4,50,61,-11,58,12
New England Revolution,40,12,19,9,53,64,-11,55,13
New York Red Bulls,40,10,23,7,62,62,0,53,14
Atlanta United FC,40,11,19,10,53,58,-5,52,15
Minnesota,40,11,18,11,48,57,-9,51,16
San Jose Earthquakes,40,9,17,14,74,50,24,44,17
Orlando City,40,8,20,12,46,57,-11,44,18
Real Salt Lake,40,8,20,12,47,66,-19,44,19
Inter Miami,40,8,19,13,49,63,-14,43,20
Colorado Rapids,40,8,16,16,55,70,-15,40,21
Charlotte FC,40,6,18,16,58,71,-13,36,22
Sporting Kansas City,40,5,20,15,53,59,-6,35,23
Houston Dynamo,40,4,22,14,58,54,4,34,24
Toronto FC,40,4,20,16,66,77,-11,32,25
Chicago Fire,40,3,22,15,48,71,-23,31,26
Vancouver Whitecaps,40,2,14,24,52,60,-8,20,27
D.C. United,40,0,17,23,52,79,-27,17,28
Philadelphia Union,41,37,4,0,77,36,41,115,1
Los Angeles FC,41,32,8,1,114,37,77,104,2
Austin FC,41,25,13,3,79,54,25,88,3
FC Dallas,41,24,14,3,50,63,-13,86,4
CF Montreal,41,22,13,6,111,65,46,79,5
Los Angeles Galaxy,41,21,15,5,74,50,24,78,6
FC Cincinnati,41,19,15,7,74,70,4,72,7
Columbus Crew,41,17,19,5,62,59,3,70,8
New York City FC,41,15,24,2,65,57,8,69,9
Seattle Sounders,41,16,17,8,59,56,3,65,10
Portland Timbers,41,16,17,8,67,66,1,65,11
Nashville SC,41,12,25,4,52,62,-10,61,12
New England Revolution,41,12,20,9,54,65,-11,56,13
New York Red Bulls,41,11,23,7,64,65,-1,56,14
Minnesota,41,12,18,11,49,57,-8,54,15
Atlanta United FC,41,11,19,11,55,59,-4,52,16
Real Salt Lake,41,9,20,12,49,66,-17,47,17
San Jose Earthquakes,41,9,17,15,79,51,28,44,18
Orlando City,41,8,20,13,47,57,-10,44,19
Inter Miami,41,8,19,14,49,66,-17,43,20
Colorado Rapids,41,8,17,16,57,72,-15,41,21
Charlotte FC,41,7,18,16,58,72,-14,39,22
Sporting Kansas City,41,5,21,15,57,59,-2,36,23
Houston Dynamo,41,4,22,15,60,56,4,34,24
Chicago Fire,41,4,22,15,48,72,-24,34,25
Toronto FC,41,4,21,16,70,79,-9,33,26
Vancouver Whitecaps,41,2,15,24,53,64,-11,21,27
D.C. United,41,0,17,24,53,81,-28,17,28
Philadelphia Union,42,38,4,0,82,36,46,118,1
Los Angeles FC,42,33,8,1,116,38,78,107,2
Austin FC,42,25,14,3,79,55,24,89,3
FC Dallas,42,24,15,3,50,64,-14,87,4
CF Montreal,42,22,14,6,114,65,49,80,5
Los Angeles Galaxy,42,21,16,5,76,52,24,79,6
FC Cincinnati,42,20,15,7,80,72,8,75,7
New York City FC,42,16,24,2,65,58,7,72,8
Columbus Crew,42,17,20,5,65,60,5,71,9
Seattle Sounders,42,16,18,8,62,57,5,66,10
Portland Timbers,42,16,18,8,69,68,1,66,11
Nashville SC,42,13,25,4,53,64,-11,64,12
New York Red Bulls,42,12,23,7,66,65,1,59,13
New England Revolution,42,12,21,9,57,68,-11,57,14
Minnesota,42,12,19,11,51,60,-9,55,15
Atlanta United FC,42,11,20,11,57,61,-4,53,16
Real Salt Lake,42,10,20,12,51,67,-16,50,17
Orlando City,42,8,21,13,51,58,-7,45,18
San Jose Earthquakes,42,9,17,16,81,55,26,44,19
Colorado Rapids,42,9,17,16,59,75,-16,44,20
Inter Miami,42,8,20,14,49,67,-18,44,21
Charlotte FC,42,7,19,16,58,77,-19,40,22
Sporting Kansas City,42,5,22,15,58,60,-2,37,23
Chicago Fire,42,4,23,15,48,73,-25,35,24
Houston Dynamo,42,4,22,16,60,60,0,34,25
Toronto FC,42,4,22,16,70,81,-11,34,26
Vancouver Whitecaps,42,2,16,24,54,65,-11,22,27
D.C. United,42,0,17,25,53,86,-33,17,28
Philadelphia Union,43,39,4,0,84,37,47,121,1
Los Angeles FC,43,34,8,1,116,39,77,110,2
Austin FC,43,25,15,3,83,58,25,90,3
FC Dallas,43,24,16,3,51,64,-13,88,4
CF Montreal,43,23,14,6,120,67,53,83,5
Los Angeles Galaxy,43,21,17,5,76,52,24,80,6
FC Cincinnati,43,21,15,7,85,74,11,78,7
New York City FC,43,17,24,2,67,58,9,75,8
Columbus Crew,43,17,21,5,66,61,5,72,9
Seattle Sounders,43,16,19,8,64,58,6,67,10
Portland Timbers,43,16,19,8,70,71,-1,67,11
Nashville SC,43,14,25,4,57,64,-7,67,12
New York Red Bulls,43,13,23,7,67,65,2,62,13
Minnesota,43,13,19,11,51,63,-12,58,14
New England Revolution,43,12,22,9,58,69,-11,58,15
Atlanta United FC,43,11,21,11,59,65,-6,54,16
Real Salt Lake,43,10,21,12,52,71,-19,51,17
Orlando City,43,8,22,13,52,59,-7,46,18
Colorado Rapids,43,9,18,16,61,77,-16,45,19
Inter Miami,43,8,21,14,49,67,-18,45,20
San Jose Earthquakes,43,9,17,17,84,59,25,44,21
Charlotte FC,43,8,19,16,58,79,-21,43,22
Sporting Kansas City,43,5,23,15,58,61,-3,38,23
Chicago Fire,43,4,24,15,48,74,-26,36,24
Houston Dynamo,43,4,22,17,65,60,5,34,25
Toronto FC,43,4,22,17,71,82,-11,34,26
Vancouver Whitecaps,43,2,17,24,55,68,-13,23,27
D.C. United,43,0,17,26,54,88,-34,17,28
Philadelphia Union,44,40,4,0,85,38,47,124,1
Los Angeles FC,44,34,9,1,120,44,76,111,2
Austin FC,44,25,15,4,84,59,25,90,3
FC Dallas,44,24,17,3,52,66,-14,89,4
CF Montreal,44,23,15,6,122,69,53,84,5
FC Cincinnati,44,22,15,7,87,74,13,81,6
Los Angeles Galaxy,44,21,17,6,77,56,21,80,7
New York City FC,44,18,24,2,72,58,14,78,8
Columbus Crew,44,17,21,6,69,63,6,72,9
Nashville SC,44,15,25,4,59,65,-6,70,10
Seattle Sounders,44,16,19,9,66,61,5,67,11
Portland Timbers,44,16,19,9,70,71,-1,67,12
New York Red Bulls,44,14,23,7,68,66,2,65,13
Minnesota,44,14,19,11,53,65,-12,61,14
New England Revolution,44,12,22,10,58,71,-13,58,15
Atlanta United FC,44,11,21,12,59,71,-12,54,16
Real Salt Lake,44,10,22,12,53,75,-22,52,17
Colorado Rapids,44,9,19,16,61,77,-16,46,18
Charlotte FC,44,9,19,16,60,81,-21,46,19
Orlando City,44,8,22,14,52,61,-9,46,20
Inter Miami,44,8,21,15,51,71,-20,45,21
San Jose Earthquakes,44,9,17,18,85,68,17,44,22
Sporting Kansas City,44,5,23,16,59,62,-3,38,23
Chicago Fire,44,4,25,15,49,75,-26,37,24
Houston Dynamo,44,4,22,18,66,62,4,34,25
Toronto FC,44,4,22,18,72,85,-13,34,26
Vancouver Whitecaps,44,2,18,24,58,71,-13,24,27
D.C. United,44,0,17,27,54,91,-37,17,28
Philadelphia Union,45,41,4,0,86,38,48,127,1
Los Angeles FC,45,35,9,1,123,44,79,114,2
Austin FC,45,25,16,4,86,61,25,91,3
FC Dallas,45,24,18,3,52,67,-15,90,4
CF Montreal,45,23,16,6,125,69,56,85,5
FC Cincinnati,45,22,16,7,89,75,14,82,6
Los Angeles Galaxy,45,21,18,6,79,60,19,81,7
New York City FC,45,19,24,2,73,60,13,81,8
Columbus Crew,45,17,22,6,70,64,6,73,9
Nashville SC,45,16,25,4,59,67,-8,73,10
Seattle Sounders,45,16,20,9,67,61,6,68,11
Portland Timbers,45,16,20,9,73,73,0,68,12
New York Red Bulls,45,15,23,7,71,66,5,68,13
Minnesota,45,15,19,11,54,67,-13,64,14
New England Revolution,45,12,23,10,59,73,-14,59,15
Atlanta United FC,45,11,22,12,60,72,-12,55,16
Real Salt Lake,45,11,22,12,54,76,-22,55,17
Colorado Rapids,45,9,20,16,62,77,-15,47,18
Charlotte FC,45,9,20,16,62,82,-20,47,19
Orlando City,45,8,23,14,54,62,-8,47,20
Inter Miami,45,8,22,15,52,72,-20,46,21
San Jose Earthquakes,45,9,17,19,86,68,18,44,22
Sporting Kansas City,45,5,24,16,61,64,-3,39,23
Chicago Fire,45,4,26,15,50,75,-25,38,24
Houston Dynamo,45,4,23,18,66,63,3,35,25
Toronto FC,45,4,22,19,76,86,-10,34,26
Vancouver Whitecaps,45,2,19,24,58,74,-16,25,27
D.C. United,45,0,17,28,55,96,-41,17,28
Philadelphia Union,46,42,4,0,87,38,49,130,1
Los Angeles FC,46,36,9,1,125,45,80,117,2
Austin FC,46,25,17,4,87,65,22,92,3
FC Dallas,46,24,19,3,56,70,-14,91,4
CF Montreal,46,23,17,6,125,71,54,86,5
FC Cincinnati,46,23,16,7,90,75,15,85,6
New York City FC,46,20,24,2,77,61,16,84,7
Los Angeles Galaxy,46,21,19,6,81,63,18,82,8
Nashville SC,46,17,25,4,59,69,-10,76,9
Columbus Crew,46,17,23,6,71,64,7,74,10
New York Red Bulls,46,16,23,7,72,66,6,71,11
Seattle Sounders,46,16,21,9,67,64,3,69,12
Portland Timbers,46,16,21,9,74,73,1,69,13
Minnesota,46,15,20,11,59,68,-9,65,14
New England Revolution,46,12,24,10,60,76,-16,60,15
Real Salt Lake,46,12,22,12,54,77,-23,58,16
Atlanta United FC,46,11,23,12,60,72,-12,56,17
Colorado Rapids,46,9,21,16,64,78,-14,48,18
Charlotte FC,46,9,21,16,64,85,-21,48,19
Orlando City,46,8,23,15,55,62,-7,47,20
Inter Miami,46,8,22,16,54,76,-22,46,21
San Jose Earthquakes,46,9,17,20,87,69,18,44,22
Sporting Kansas City,46,5,24,17,61,65,-4,39,23
Chicago Fire,46,4,26,16,51,75,-24,38,24
Houston Dynamo,46,4,23,19,66,66,0,35,25
Toronto FC,46,4,22,20,76,88,-12,34,26
Vancouver Whitecaps,46,2,20,24,60,76,-16,26,27
D.C. United,46,0,17,29,56,98,-42,17,28
Philadelphia Union,47,43,4,0,89,38,51,133,1
Los Angeles FC,47,36,10,1,126,46,80,118,2
Austin FC,47,25,17,5,89,67,22,92,3
FC Dallas,47,24,20,3,59,72,-13,92,4
New York City FC,47,21,24,2,77,63,14,87,5
CF Montreal,47,23,17,7,127,74,53,86,6
FC Cincinnati,47,23,17,7,95,76,19,86,7
Los Angeles Galaxy,47,21,19,7,81,66,15,82,8
Nashville SC,47,18,25,4,59,70,-11,79,9
Columbus Crew,47,17,23,7,73,64,9,74,10
New York Red Bulls,47,17,23,7,74,70,4,74,11
Seattle Sounders,47,16,21,10,68,65,3,69,12
Portland Timbers,47,16,21,10,75,75,0,69,13
Minnesota,47,15,21,11,61,70,-9,66,14
New England Revolution,47,12,24,11,61,76,-15,60,15
Real Salt Lake,47,12,23,12,56,78,-22,59,16
Atlanta United FC,47,11,23,13,62,73,-11,56,17
Charlotte FC,47,9,22,16,66,86,-20,49,18
Colorado Rapids,47,9,21,17,64,80,-16,48,19
Orlando City,47,8,23,16,55,66,-11,47,20
Inter Miami,47,8,22,17,57,80,-23,46,21
San Jose Earthquakes,47,9,17,21,88,70,18,44,22
Sporting Kansas City,47,5,24,18,62,65,-3,39,23
Chicago Fire,47,4,26,17,52,75,-23,38,24
Houston Dynamo,47,4,23,20,67,71,-4,35,25
Toronto FC,47,4,22,21,81,94,-13,34,26
Vancouver Whitecaps,47,2,21,24,61,78,-17,27,27
D.C. United,47,0,17,30,56,105,-49,17,28
Philadelphia Union,48,44,4,0,94,39,55,136,1
Los Angeles FC,48,36,11,1,130,49,81,119,2
Austin FC,48,25,18,5,90,70,20,93,3
FC Dallas,48,24,21,3,61,73,-12,93,4
New York City FC,48,22,24,2,78,64,14,90,5
CF Montreal,48,23,18,7,127,75,52,87,6
FC Cincinnati,48,23,18,7,98,78,20,87,7
Los Angeles Galaxy,48,21,20,7,81,67,14,83,8
Nashville SC,48,19,25,4,61,70,-9,82,9
New York Red Bulls,48,18,23,7,76,71,5,77,10
Columbus Crew,48,17,24,7,74,64,10,75,11
Seattle Sounders,48,16,22,10,70,66,4,70,12
Portland Timbers,48,16,21,11,76,77,-1,69,13
Minnesota,48,15,22,11,62,71,-9,67,14
New England Revolution,48,12,24,12,61,77,-16,60,15
Real Salt Lake,48,12,24,12,58,79,-21,60,16
Atlanta United FC,48,11,23,14,62,75,-13,56,17
Charlotte FC,48,10,22,16,67,86,-19,52,18
Colorado Rapids,48,9,21,18,64,81,-17,48,19
Orlando City,48,8,23,17,59,67,-8,47,20
Inter Miami,48,8,22,18,60,82,-22,46,21
San Jose Earthquakes,48,9,17,22,88,71,17,44,22
Sporting Kansas City,48,5,24,19,64,68,-4,39,23
Chicago Fire,48,4,26,18,52,77,-25,38,24
Houston Dynamo,48,4,23,21,67,72,-5,35,25
Toronto FC,48,4,22,22,81,96,-15,34,26
Vancouver Whitecaps,48,2,22,24,61,80,-19,28,27
D.C. United,48,0,17,31,57,106,-49,17,28
Philadelphia Union,49,45,4,0,96,39,57,139,1
Los Angeles FC,49,36,12,1,136,50,86,120,2
Austin FC,49,25,19,5,92,71,21,94,3
FC Dallas,49,24,22,3,63,73,-10,94,4
New York City FC,49,23,24,2,82,64,18,93,5
CF Montreal,49,23,19,7,128,77,51,88,6
FC Cincinnati,49,23,19,7,102,79,23,88,7
Nashville SC,49,20,25,4,63,70,-7,85,8
Los Angeles Galaxy,49,21,21,7,81,69,12,84,9
New York Red Bulls,49,19,23,7,78,71,7,80,10
Columbus Crew,49,17,25,7,74,65,9,76,11
Seattle Sounders,49,16,23,10,71,69,2,71,12
Portland Timbers,49,16,22,11,77,78,-1,70,13
Minnesota,49,15,23,11,66,72,-6,68,14
New England Revolution,49,12,25,12,63,79,-16,61,15
Real Salt Lake,49,12,25,12,60,79,-19,61,16
Atlanta United FC,49,11,23,15,63,77,-14,56,17
Charlotte FC,49,10,23,16,67,86,-19,53,18
Colorado Rapids,49,9,21,19,65,83,-18,48,19
Orlando City,49,8,23,18,61,68,-7,47,20
Inter Miami,49,8,22,19,62,82,-20,46,21
San Jose Earthquakes,49,9,17,23,90,75,15,44,22
Sporting Kansas City,49,5,24,20,64,69,-5,39,23
Chicago Fire,49,4,26,19,52,79,-27,38,24
Houston Dynamo,49,4,23,22,67,72,-5,35,25
Toronto FC,49,4,22,23,82,97,-15,34,26
Vancouver Whitecaps,49,2,23,24,63,81,-18,29,27
D.C. United,49,0,17,32,58,109,-51,17,28
Philadelphia Union,50,46,4,0,100,39,61,142,1
Los Angeles FC,50,37,12,1,139,52,87,123,2
New York City FC,50,24,24,2,84,64,20,96,3
Austin FC,50,25,20,5,92,73,19,95,4
FC Dallas,50,24,23,3,63,74,-11,95,5
CF Montreal,50,23,20,7,132,78,54,89,6
FC Cincinnati,50,23,20,7,105,82,23,89,7
Nashville SC,50,21,25,4,63,70,-7,88,8
Los Angeles Galaxy,50,21,22,7,83,71,12,85,9
New York Red Bulls,50,20,23,7,81,71,10,83,10
Columbus Crew,50,17,26,7,77,65,12,77,11
Seattle Sounders,50,16,24,10,74,71,3,72,12
Portland Timbers,50,16,23,11,78,78,0,71,13
Minnesota,50,15,24,11,69,72,-3,69,14
New England Revolution,50,12,26,12,65,83,-18,62,15
Real Salt Lake,50,12,26,12,62,81,-19,62,16
Atlanta United FC,50,11,24,15,63,78,-15,57,17
Charlotte FC,50,10,24,16,68,86,-18,54,18
Colorado Rapids,50,9,22,19,68,84,-16,49,19
Orlando City,50,8,24,18,61,70,-9,48,20
Inter Miami,50,8,23,19,64,83,-19,47,21
San Jose Earthquakes,50,9,18,23,90,77,13,45,22
Sporting Kansas City,50,5,25,20,67,72,-5,40,23
Chicago Fire,50,4,27,19,53,80,-27,39,24
Houston Dynamo,50,4,24,22,68,74,-6,36,25
Toronto FC,50,4,22,24,86,97,-11,34,26
Vancouver Whitecaps,50,2,24,24,64,84,-20,30,27
D.C. United,50,0,17,33,59,111,-52,17,28
Philadelphia Union,51,47,4,0,100,39,61,145,1
Los Angeles FC,51,38,12,1,142,53,89,126,2
New York City FC,51,25,24,2,85,65,20,99,3
Austin FC,51,25,21,5,95,74,21,96,4
FC Dallas,51,24,24,3,63,75,-12,96,5
Nashville SC,51,22,25,4,65,70,-5,91,6
CF Montreal,51,23,21,7,137,78,59,90,7
FC Cincinnati,51,23,21,7,106,84,22,90,8
New York Red Bulls,51,21,23,7,84,71,13,86,9
Los Angeles Galaxy,51,21,23,7,85,74,11,86,10
Columbus Crew,51,17,27,7,79,68,11,78,11
Seattle Sounders,51,16,25,10,74,73,1,73,12
Portland Timbers,51,16,24,11,79,82,-3,72,13
Minnesota,51,15,25,11,72,74,-2,70,14
New England Revolution,51,12,27,12,67,83,-16,63,15
Real Salt Lake,51,12,27,12,63,83,-20,63,16
Atlanta United FC,51,11,25,15,63,78,-15,58,17
Charlotte FC,51,10,25,16,69,86,-17,55,18
Colorado Rapids,51,9,22,20,70,86,-16,49,19
Orlando City,51,8,24,19,63,71,-8,48,20
Inter Miami,51,8,23,20,65,84,-19,47,21
San Jose Earthquakes,51,9,18,24,92,79,13,45,22
Sporting Kansas City,51,5,25,21,68,72,-4,40,23
Chicago Fire,51,4,27,20,55,80,-25,39,24
Houston Dynamo,51,4,24,23,71,76,-5,36,25
Toronto FC,51,4,22,25,86,99,-13,34,26
Vancouver Whitecaps,51,2,24,25,64,85,-21,30,27
D.C. United,51,0,17,34,61,113,-52,17,28
Philadelphia Union,52,47,5,0,102,40,62,146,1
Los Angeles FC,52,38,13,1,142,56,86,127,2
New York City FC,52,26,24,2,86,66,20,102,3
Austin FC,52,25,21,6,97,74,23,96,4
FC Dallas,52,24,24,4,65,75,-10,96,5
Nashville SC,52,23,25,4,71,72,-1,94,6
CF Montreal,52,23,21,8,137,80,57,90,7
FC Cincinnati,52,23,21,8,107,88,19,90,8
New York Red Bulls,52,21,24,7,87,72,15,87,9
Los Angeles Galaxy,52,21,23,8,88,75,13,86,10
Columbus Crew,52,17,27,8,80,73,7,78,11
Seattle Sounders,52,16,25,11,75,75,0,73,12
Portland Timbers,52,16,24,12,80,84,-4,72,13
Minnesota,52,15,25,12,74,74,0,70,14
New England Revolution,52,12,27,13,68,85,-17,63,15
Real Salt Lake,52,12,27,13,64,84,-20,63,16
Atlanta United FC,52,11,25,16,64,79,-15,58,17
Charlotte FC,52,10,25,17,69,88,-19,55,18
Colorado Rapids,52,9,22,21,72,87,-15,49,19
Orlando City,52,8,24,20,63,74,-11,48,20
Inter Miami,52,8,23,21,66,87,-21,47,21
San Jose Earthquakes,52,9,18,25,93,81,12,45,22
Sporting Kansas City,52,5,25,22,69,72,-3,40,23
Chicago Fire,52,4,27,21,55,85,-30,39,24
Houston Dynamo,52,4,24,24,72,77,-5,36,25
Toronto FC,52,4,22,26,86,103,-17,34,26
Vancouver Whitecaps,52,2,24,26,64,89,-25,30,27
D.C. United,52,0,17,35,61,114,-53,17,28
Philadelphia Union,53,47,6,0,103,42,61,147,1
Los Angeles FC,53,38,14,1,143,57,86,128,2
New York City FC,53,26,25,2,87,69,18,103,3
Austin FC,53,25,22,6,97,76,21,97,4
FC Dallas,53,24,25,4,65,76,-11,97,5
Nashville SC,53,23,26,4,73,72,1,95,6
CF Montreal,53,23,21,9,138,81,57,90,7
FC Cincinnati,53,23,21,9,111,90,21,90,8
New York Red Bulls,53,21,25,7,87,72,15,88,9
Los Angeles Galaxy,53,21,23,9,88,76,12,86,10
Columbus Crew,53,17,28,8,82,75,7,79,11
Seattle Sounders,53,16,25,12,77,75,2,73,12
Portland Timbers,53,16,24,13,85,86,-1,72,13
Minnesota,53,15,25,13,75,76,-1,70,14
New England Revolution,53,12,27,14,71,87,-16,63,15
Real Salt Lake,53,12,27,14,64,86,-22,63,16
Atlanta United FC,53,11,25,17,64,84,-20,58,17
Charlotte FC,53,10,25,18,69,91,-22,55,18
Colorado Rapids,53,9,22,22,72,88,-16,49,19
Orlando City,53,8,24,21,63,79,-16,48,20
Inter Miami,53,8,23,22,68,90,-22,47,21
San Jose Earthquakes,53,9,18,26,93,84,9,45,22
Sporting Kansas City,53,5,25,23,69,73,-4,40,23
Chicago Fire,53,4,27,22,55,88,-33,39,24
Houston Dynamo,53,4,24,25,73,78,-5,36,25
Toronto FC,53,4,22,27,86,105,-19,34,26
Vancouver Whitecaps,53,2,24,27,64,92,-28,30,27
D.C. United,53,0,17,36,61,117,-56,17,28
Philadelphia Union,54,47,7,0,104,44,60,148,1
Los Angeles FC,54,38,15,1,143,58,85,129,2
New York City FC,54,26,26,2,87,71,16,104,3
FC Dallas,54,24,26,4,66,79,-13,98,4
Austin FC,54,25,22,7,100,78,22,97,5
Nashville SC,54,23,27,4,73,74,-1,96,6
CF Montreal,54,23,21,10,140,81,59,90,7
FC Cincinnati,54,23,21,10,111,92,19,90,8
New York Red Bulls,54,21,26,7,89,72,17,89,9
Los Angeles Galaxy,54,21,23,10,89,77,12,86,10
Columbus Crew,54,17,28,9,84,76,8,79,11
Seattle Sounders,54,16,25,13,78,77,1,73,12
Portland Timbers,54,16,24,14,88,89,-1,72,13
Minnesota,54,15,25,14,75,78,-3,70,14
New England Revolution,54,12,27,15,73,88,-15,63,15
Real Salt Lake,54,12,27,15,64,86,-22,63,16
Atlanta United FC,54,11,25,18,65,84,-19,58,17
Charlotte FC,54,10,25,19,71,97,-26,55,18
Colorado Rapids,54,9,22,23,73,88,-15,49,19
Orlando City,54,8,24,22,64,80,-16,48,20
Inter Miami,54,8,23,23,69,92,-23,47,21
San Jose Earthquakes,54,9,18,27,96,88,8,45,22
Sporting Kansas City,54,5,25,24,70,75,-5,40,23
Chicago Fire,54,4,27,23,57,88,-31,39,24
Houston Dynamo,54,4,24,26,74,80,-6,36,25
Toronto FC,54,4,22,28,86,109,-23,34,26
Vancouver Whitecaps,54,2,24,28,64,94,-30,30,27
D.C. United,54,0,17,37,61,119,-58,17,28
